R 800 600
NO pics/redbrick.xpm
SO pics/wood.xpm
WE pics/greystone.xpm
EA pics/bluestone.xpm
S pics/barrel.xpm

F 40,40,40
C 150,150,150

        111111111111111111111111
        100000000000000000000001
111111111100000000000000000000001
100000000000000000000001111111111111111111111
100000000002220000000001
100000022020200000020001
10000000000000000022000111111111
100000000000000000020000000000001
100000000000000000000001111111111
100000000000000010000001
120000000000020000000021
100000000000000000000001
100000000000010000020001
100000000000000000220011
10000000000000000N002001
100000000000000000000001
100000000000000000000001
100000200000000000000001
100000000200000000000021
100000000000000000000001
100000000000000000000001
100000000000000000000001
100000000000000000000001
111111111111111111111111
